NO incs/assets/textures/Bricks_North1.xpm
SO incs/assets/textures/Bricks_South1.xpm
WE incs/assets/textures/Bricks_West1.xpm
EA incs/assets/textures/Bricks_East1.xpm

F 139,69,19
C 135,216,251

1111111111111111111111111
1111111111111111111111111
1111111011111111111111111
1111111111111111111111111
1111111111111111111111111
1111111111111111111111111
1111111111111111111111111
1111111111111111111111111
1111111111111111111111111
1111111111111111111111111
1111111111111111111111111
1111111111111111111111111
111111111111N111111111111
1111111111111111111111111
1111111111111111111111111
1111111111111111111111111
1111111111111111111111111
1111111111111111111111111
1111111111111111111111111
1111111111111111111111111
1111111111111111111111111
