
SO ./incs/assets/textures/Bricks_South.xpm

EA ./incs/assets/textures/Bricks_East.xpm

F 0,0,0


WE ./incs/assets/textures/Bricks_West.xpm

C 0,0,0
NO ./incs/assets/textures/Bricks_North.xpm

111111
100101
101001
1100N1
111111
