NO incs/assets/textures/Bricks_North1.xpm
SO incs/assets/textures/Bricks_South1.xpm
WE incs/assets/textures/Bricks_West1.xpm
EA incs/assets/textures/Bricks_East1.xpm

F 0,0,0
C 3,3,3

1111111
10E0001
1000001
1k000c1
111M111
