NO incs/assets/textures/Bricks_North1.xpm
SO incs/assets/textures/Bricks_South1.xpm
WE incs/assets/textures/Bricks_West1.xpm
EA incs/assets/textures/Bricks_East1.xpm

F 0,0,0
C 0,0,0

    1111111111111111111
    1000000000000000001
    1011111111111111101
    1010000000000000101
    1010111111111110101
    1010100000000010101
    1010101111111010101
    1010101000001010101
    1010101010101010101
    1010101010N01010101
    1010101010101010101
    1010101011111010101
    1010101000000010101
    1010111111111110101
    1010000000000000101
    1011111111111111101
    1000000000000000001
    1111111111111111111
