NO ./textures/north.xpm
SO ./textures/south.xpm
WE ./textures/west.xpm
EA ./textures/east.xpm
F 120,100,0
C 255,255,255
C 123,123,123
111111
100001
10N001
100001
111111
