NO incs/assets/textures/Bricks_North1.xpm
SO incs/assets/textures/Bricks_South1.xpm
WE incs/assets/textures/Bricks_West1.xpm
EA incs/assets/textures/Bricks_East1.xpm

F 139,69,19
C 30,144,255

1111111111111111111
1000000000000000001
1000000000000000001
1000000000000000001
1000000000000000001
1000000000000000001
1000000000000000001
1000000N00000000001
1000000000000000001
1000000000000000001
1111111111100000001
          100000001
          100000001
          100000001
          100000001
          111111111
