NO ./textures/north.xpm
SO ./textures/south.xpm
WE ./textures/west.xpm
EA ./textures/east.xpm

F 101,67,33
C 173,216,230

 111111
 100001
 100001
 10N001
 111111
