NO ./textures/north.xpm
SO ./textures/south.xpm
WE ./textures/west.xpm
EA ./textures/east.xpm

F 101,67,33
C 173,216,230

11111
10001
1000 
10N01
11111
