NO incs/assets/textures/Bricks_North1.xpm
SO incs/assets/textures/Bricks_South1.xpm
WE incs/assets/textures/Bricks_West1.xpm
EA incs/assets/textures/Bricks_East1.xpm

F 101,67,33
C 173,216,230

11111111111111111111111111111111111111111111111111111111111
10000000000000000000000000000000000000000000000000000000001
10110000000000000000000000000000000000000000000000000000001
10100000000000000000000000000000000000000000000000000000001
10100000000000000000111111111111111111000000000000000000001
10100000000000000000100000000000000001000000000000000000001
10100000000000000000100000000000000001000000000000000000001
10100000000000000000100000000000000001000000000000000000001
10100000000000000000100000E00000000001000000000000000000001
10100000000000000000100000000000000001000000000000000000001
10100000000000000000100000000000000001000000000000000000001
10100000000000000000111111111111111111000000000000000000001
10100000000000000000000000000000000000000000000000000000001
10100000000000000000000000000000000000000000000000000000001
10110000000000000000000000000000000000000000000000000000001
10000000000000000000000000000000000000000000000000000000001
11111111111111111111111111111111111111111111111111111111111
