NO incs/assets/textures/Bricks_North1.xpm
SO incs/assets/textures/Bricks_South1.xpm
WE incs/assets/textures/Bricks_West1.xpm
EA incs/assets/textures/Bricks_East1.xpm

F 0,0,0
C 0,0,0

111111111111111
100000000000001
100c00000c00001
100000000000001
10000000N000001
100000000000001
100c00000c00001
100000000000001
111111111111111
