NO ./textures/north.xpm
SO ./textures/south.xpm
WE ./textures/west.xpm
EA ./textures/east.xpm

F 160,82,45
C 70,130,180

           11111111111
           10000000001
           10000000001
           10000000001
     1111111000000000111111
     1000000000000000000001
     1000000000000000000001
     1000000000N00000000001
     1000000000000000000001
     1000000000000000000001
     1111111000000000111111
           10000000001
           10000000001
           10000000001
           11111111111
