NO ./textures/north.xpm
SO ./textures/south.xpm
WE ./textures/west.xpm
EA ./textures/east.xpm

F 101,67,33
C 173,216,230

       111111111
     1110000001111
   111000000000001
  11000000000000011
 1100000000000000001
 100000000000000000011
11000000000000000000001
1000000000N000000000001
11000000000000000000001
 100000000000000000011
 1100000000000000001
  11000000000000011
   111000000000001
     1110000001111
       111111111
