NO ./incs/assets/textures/Bricks_North1.xpm
SO ./incs/assets/textures/Bricks_South1.xpm
WE ./incs/assets/textures/Bricks_West1.xpm
EA ./incs/assets/textures/Bricks_East1.xpm
DR ./incs/assets/textures/door.xpm

F 0,0,0
C 0,0,0

1111111111
100cD00001
100010D001
1N001c0001
1000Dc0001
1111111111