NO incs/assets/textures/Bricks_North.xpm
SO incs/assets/textures/Bricks_South.xpm
WE incs/assets/textures/Bricks_West.xpm
EA incs/assets/textures/Bricks_East.xpm

F 101,67,33
C 173,216,230

11111
10001
10 01
10N01
11111
