NO ./textures/north.xpm
SO ./textures/south.xpm
WE ./textures/west.xpm
EA ./textures/east.xpm

F 64,128,192
C 255,255,224

             111111111111111
             100000000000001
             100000000000001
     111111111000000000000001
     100000000000000000000001
     100000000000000000000001
111111000000000000000000000001
100000000000000000000000000001
100000000000000000000000000001
100000000000N0000000000000001
100000000000000000000000000001
100000000000000000000000000001
111111000000000000000000000001
     100000000000000000000001
     100000000000000000000001
     111111111000000000000001
             100000000000001
             100000000000001
             111111111111111
