NO incs/assets/textures/Bricks_North.xpm
SO incs/assets/textures/Bricks_South.xpm
WE incs/assets/textures/Bricks_West.xpm
EA incs/assets/textures/Bricks_East.xpm

F 139,69,19
C 135,206,250

1111111111111111111111111
1000000000000000000000001
1010101010101010101010101
1000000000000000000000001
1010101010101010101010101
1000000000000000000000001
1010101010101010101010101
1000000000000000000000001
1010101010101010101010101
1000000000000000000000001
1010101010101010101010101
1000000000000000000000001
101010101010N010101010101
1000000000000000000000001
1010101010101010101010101
1000000000000000000000001
1010101010101010101010101
1000000000000000000000001
1010101010101010101010101
1000000000000000000000001
1111111111111111111111111
