NO ./textures/north.xpm
SO ./textures/south.xpm
WE ./textures/west.xpm
EA ./textures/east.xpm

F 120,80,40
C 135,206,235

11111111
10000001
10000001
10000N01
10000001
10000001
11111111
