NO incs/assets/textures/Bricks_North.xpm
SO incs/assets/textures/Bricks_South.xpm
WE incs/assets/textures/Bricks_West.xpm
EA incs/assets/textures/Bricks_East.xpm

F 100,50,0
C 0,100,200

1111111
10N0001
100000M
10000c1
1111111