NO ./textures/north.xpm
SO ./textures/south.xpm
WE ./textures/west.xpm
EA ./textures/east.xpm

F 100,50,0
C 0,100,200

1111111
10N0001
1000001
1000001
1111111
