NO ./textures/north.xpm
SO ./textures/south.xpm
WE ./textures/west.xpm
EA ./textures/east.xpm

F 101,67,33
C 173,216,230

111111111111111111111111111111111111111111111111111111111111111111111111
100000000000000000000000000000000000000000000000000000000000000000000001
100000000000000000000000000000000000000000000000000000000000000000000001
100000000000000000000000000000000000000000000000000000000000000000000001
100111111111111111111111111111111111111111111111111111111111111111000001
100100000000000000000000000000000000000000000000000000000000000001000001
100100000000000000000000000000000000000000000000000000000000000001000001
100100000000000000000000000000000000000000000000000000000000000001000001
100100000000000111111111111111111111111111111111111000000000000001000001
100100000000000100000000000000000000000000000000001000000000000001000001
100100000000000100000000000000000000000000000000001000000000000001000001
100100000000000100000000000000000000000000000000001000000000000001000001
100100000000000100000000000000000000000000000000001000000000000001000001
100100000000000100000000000000000000000000000000001000000000000001000001
100100000000000100000000000000000000000000000000001000000000000001000001
100100000000000100000000000111111111000000000000001000000000000001000001
100100000000000100000000000100000001000000000000001000000000000001000001
100100000000000100000000000100000001000000000000001000000000000001000001
100100000000000100000000000100000001000000000000001000000000000001000001
100100000000000100000000000100000001000000000000001000000000000001000001
100100000000000100000000000100000001000000000000001000000000000001000001
100100000000000100000000000100000001000000000000001000000000000001000001
100100000000000100000000000100N00001000000000000001000000000000001000001
100100000000000100000000000100000001000000000000001000000000000001000001
100100000000000100000000000100000001000000000000001000000000000001000001
100100000000000100000000000100000001000000000000001000000000000001000001
100100000000000100000000000100000001000000000000001000000000000001000001
100100000000000100000000000100000001000000000000001000000000000001000001
100100000000000100000000000100000001000000000000001000000000000001000001
100100000000000100000000000111111111000000000000001000000000000001000001
100100000000000100000000000000000000000000000000001000000000000001000001
100100000000000100000000000000000000000000000000001000000000000001000001
100100000000000100000000000000000000000000000000001000000000000001000001
100100000000000100000000000000000000000000000000001000000000000001000001
100100000000000100000000000000000000000000000000001000000000000001000001
100100000000000100000000000000000000000000000000001000000000000001000001
100100000000000111111111111111111111111111111111111000000000000001000001
100100000000000000000000000000000000000000000000000000000000000001000001
100100000000000000000000000000000000000000000000000000000000000001000001
100100000000000000000000000000000000000000000000000000000000000001000001
100111111111111111111111111111111111111111111111111111111111111111000001
100000000000000000000000000000000000000000000000000000000000000000000001
100000000000000000000000000000000000000000000000000000000000000000000001
100000000000000000000000000000000000000000000000000000000000000000000001
111111111111111111111111111111111111111111111111111111111111111111111111
