NO ./path/to/north.xpm
SO ./path/to/south.xpm
WE ./path/to/west.xpm
EA ./path/to/east.xpm

F 220,100,0
C 225,30,0

1111111111
1000000001
10000N0001
1000000001
1111111111
