11111111111111111111
100000C00000000C0001
10P11000111111111111
100001000000C01E0001
1000C01111000001C001
100000000C1000000001
11110000000111100011
1000000C1000000C0011
10001110000000001111
10000000C01111000001
100C0000000000C00001
100000C1000C00000011
10000000000000100011
10000C000000000C0111
1000000C111110000011
10011100000000111001
111000000C0000000111
100000C00000C0000011
10000000000000000011
11111111111111111111
