NO ./incs/assets/textures/Bricks_North.xpm
SO ./incs/assets/textures/Bricks_South.xpm
WE ./incs/assets/textures/Bricks_West.xpm
EA ./incs/assets/textures/Bricks_East.xpm
F 220,100,0
C 225,30,0

111111
1r0101
101001
1100N1
111111
