NO incs/assets/textures/Bricks_North.xpm
SO incs/assets/textures/Bricks_South.xpm
WE incs/assets/textures/Bricks_West.xpm
EA incs/assets/textures/Bricks_East.xpm

F 120,100,0
C 255,255,255

111111
100001
10N0 1
100001
111111


1111111111111111
1000000000000001
10000S0000000001
1000000000000001
1111111111111111

1000000000000001
1000000000000001
1111111111111111