NO ./textures/north.xpm
SO ./textures/south.xpm
WE ./textures/west.xpm
EA ./textures/east.xpm

F 0,0,0
C 0,0,0

11111
1  N1
11111
