NO ./textures/north.xpm
SO ./textures/south.xpm
WE ./textures/west.xpm
EA ./textures/east.xpm

F 205,92,92
C 72,61,139

        11111111111111111111
        10000000000000000001
        10000000000000000001
        10000000000000000001
        11111111111111111001
                        1001
1111111111111111111111111001
1000000000000000000000000001
1000000000000000000000000001
1000000000000000000000000001
1000000000000000000000000001
1000000000000000000000000001
1000000000000000000000000001
10000000000N0000000000000001
1000000000000000000000000001
1000000000000000000000000001
1000000000000000000000000001
1000000000000000000000000001
1000000000000000000000000001
1111111111111111111111111001
                        1001
        11111111111111111001
        10000000000000000001
        10000000000000000001
        10000000000000000001
        11111111111111111111
