NO ./textures/wall_n.xpm
SO ./textures/wall_s.xpm
WE ./textures/wall_w.xpm
EA ./textures/wall_e.xpm
F 300,100,0
C 255,255,255

111111
100001
1000N1
100001
111111
