NO ./incs/assets/textures/Bricks_North.xpm
SO ./incs/assets/textures/Bricks_South.xpm
WE ./incs/assets/textures/Bricks_West.xpm
EA ./incs/assets/textures/Bricks_East.xpm
F 220,100,0
C 225,30,0

111111
1N0E01
101001
110001
111111
