NO ./incs/assets/textures/Bricks_North.xpm
SO ./incs/assets/textures/Bricks_South.xpm
WE ./incs/assets/textures/Bricks_West.xpm
EA ./incs/assets/textures/Bricks_East.xpm
F 220,100,0
C 225,30,0

11111111111
10001000001
10001000001
1000N000001
10001000001
11111111111
