NO incs/assets/textures/Bricks_North1.xpm
SO incs/assets/textures/Bricks_South1.xpm
WE incs/assets/textures/Bricks_West1.xpm
EA incs/assets/textures/Bricks_East1.xpm
DR incs/assets/textures/door.xpm

F 64,64,64
C 204,229,255

                    1111111111111
                  11100000000001111
               111000000000000000111
             11000000000000000000001
           110000000000000000000000011
         11000000000000000000000000001
       1100000000000000000000000000001
      110000000000000000000000000000011
    11000000000000000000000000000000001
   1100000000000000000000000000000000011
  110000000000000000000000000000000000001
  10000000000000000000000000000000000000011
 1100000000000000000000000000000000000000001
 100000000000001111D11111111000000000000000011
11000000000000000000000000000000000000000000001
10000000000000000000000000N00000000000000000001
11000000000000000000000000000000000000000000001
 100000000000000000000000000000000000000000011
 1100000000000000000000000000000000000000001
  10000000000000000000000000000000000000011
  110000000000000000000000000000000000001
   1100000000000000000000000000000000011
    11000000000000000000000000000000001
      110000000000000000000000000000011
       1100000000000000000000000000001
         11000000000000000000000000001
           110000000000000000000000011
             11000000000000000000001
               111000000000000000111
                  11100000000001111
                    1111111111111
