NO incs/assets/textures/Bricks_North1.xpm
SO incs/assets/textures/Bricks_South1.xpm
WE incs/assets/textures/Bricks_West1.xpm
EA incs/assets/textures/Bricks_East1.xpm
DR incs/assets/textures/door.xpm

F 100,50,0
C 2,100,200

1111111111
1000D00001
100000D001
10000000S1
1000D00001
1111111111
