NO incs/assets/textures/Bricks_North1.xpm
SO incs/assets/textures/Bricks_South1.xpm
WE incs/assets/textures/Bricks_West1.xpm
EA incs/assets/textures/Bricks_East1.xpm
DR incs/assets/textures/door.xpm

F 64,64,64
C 204,229,255

1111111111
1000D00001
100000D001
1N00000001
1000D00001
1111111111
