NO ./incs/assets/textures/Bricks_North.xpm
SO ./incs/assets/textures/Bricks_South.xpm
WE ./incs/assets/textures/Bricks_West.xpm
EA ./incs/assets/textures/Bricks_East.xpm

F 0,0,0
C 3,3,3

111111111111111111111111111111111111111111111111111111111111111111111111111111111111111111111111111111111111111111111111
10000000D000001111111110000111111100000000000000000000011111111111111000000000111110000000011111111111111111111111111111
100c000110100000111100000111000000000111111111111100000000000000001110000c0000111100000000000000111111111111100001111111
100000011010000000000000111000000000111111111111111111111111111000011000000011111000000000000000001111111111000011111111
111111111010000001111111110000000000111111111111111111111D11111100011000000111110000000010000000000000000000000001111111
1000000000100000111111000000000000000000000000000000000000011111100001D0011111000000000110000000000000000000000000110001
100111111010010010000100011000001111111111110000000000000001111111000001111100000000000111000000000000000000000011100k01
1001100000100100D0000D000111000111111000c001000000000c000001111111100000000000000000000011100000000000000000000111000001
100000000000000010000111111100010111100000010000000000000001111111100001100000000011100000110000000c00000000011110011111
111111100111111111111100000100010000D00000010000000000000001111111000111100000000110000000011000000000000001111000111111
111111100D00000000000000000000000000100000010000000S00000001111100001111000000001111000000001110000000000111100011111111
111000111101000000000000000011111111111111110000000000000001100000011100000011111110000000000111111111111110000011111111
111000000000000000000100111111111111111111111111111M11111111100000111000000111111100000000100001111111111000000000111111
111100000000000000000110000111111000011111111111111111111111100000100000000011111110000011110000000000000000000000011111
111111111100011000001111000011111100001100111111111111111100000000000011100000011110001111110000000000000000000000001111
111111111111111100001111000001111110000110001111000000000000000000011111000000001111111000000000000000000000000000001111
111111111001111000000111100000111110000110000000000001111111000111111100000000000010000000110000000000000000000000000111
1111111100000111000000011100000111000011100001100001111000000000000000000000000000D000000111111111111D111111111111111111
111011100000000000000011110000011000111100001111000001110111111111110000000000000010000000000000010000000011100000000001
111011000110000000000011111000000000011000000110000001110000000D00010000000000000011111111111100010000000011110000000001
1000000111110000000000111110000000001110000000000000011100k0000100010000000001111110000000000100011101100011111000000001
111111111111000111111111111000000001110000000000000000111111100100011001110001000000000000000100000000100011111000000001
111111100000001111111111110000000011100000001100000000111111100100000000010001000000000000000111111111100011111111011111
111111000000000000000111100000000111000000011110000011111111111111111111110001111111100000000000000000100011111001010001
111111111100111111000011100000001111000001110111000011111111000000000000010000000000100001000011110000100000001001010001
111111100000000011110011100000011111000011100011100000000111000000000000011111111000100001000010010000110000001001010001
1111110000000c0001111111100000011111000011100001111000111111000000000000000000001000111111000010010000011111111111010001
111110000000000011111111100000011110000011000000111110000011000000000000000000001000000000000010011111000000000000000001
1111000000000001111111111100000011000000000000001111111100111111D1111110000000001000111111111110000001011111111111000001
111110000000000011111111110000000000000001111100000000010000000000000111111000001111100000000000111111010000000000000001
1000110000000000001111111110000000000000000001100000000111111100011111000X1000000000000000000000100000010000000000000001
101111111100000000001111111000000100000000000111000000000000110000000000011000000000000000000000000000010000000000000001
101k10001100001110000011110000000110000000111110000000000000111111111111111000000000000000000000111111110000000000000001
111011111000011111000001100000001111000000001100000000000000000000000000000000000000000000000000000000000000000000000001
110001110000111111000001000000111111110011000000000000000000000000000000000000000000000000000000000000000000000000000001
110000000000111110000000000001111111111111110000000000000000000000000000000000000000000000000000000000000000000000000001
111111111111111111111000000111111111111111111111111111111111111111111111111111111111111111111111111111111111111111111111
111111111111111111111111111111111111111111111111111111111111111111111111111111111111111111111111111111111111111111111111