NO incs/assets/textures/Bricks_North1.xpm
SO incs/assets/textures/Bricks_South1.xpm
WE incs/assets/textures/Bricks_West1.xpm
EA incs/assets/textures/Bricks_East1.xpm
DR incs/assets/textures/door.xpm

F 0,0,0
C 0,0,0

111111111111111111111111111111111111111111111111111111111111
100000000000000000000000000000000000000000000000000000000001
100000000000000000001111111111111111111100000000000000000001
100000000000000000001000000000000000000100000000000000000001
100000000000000000001000000000000000000100000000000000000001
10000000000000000000D000000000E00000000D00000000000000000001
100000000000000000001000000000000000000100000000000000000001
100000000000000000001000000000000000000100000000000000000001
100000000000000000001111111111111111111100000000000000000001
100000000000000000000000000000000000000000000000000000000001
1000011111D11101111111111111111111111111111110111D1111100001
100001000000010100000000000000000000000000001010000000100001
100001000000010100000000000000000000000000001010000000100001
100001000000010100000000000000000000000000001010000000100001
100001000000010100000000000000000000000000001010000000100001
100001000000010100000000000000000000000000001010000000100001
100001000000010100000000000000000000000000001010000000100001
100001000000010100000000000000000000000000001010000000100001
100001000000010100000000000000000000000000001010000000100001
100001000000010100000000000000000000000000001010000000100001
100001000000010111111111111111111111111111111010000000100001
100001000000010000000000000000000000000000000010000000100001
100001000000010000000000000000000000000000000010000000100001
100001000000010000000000000000000000000000000010000000100001
100001000000010000000000000000000000000000000010000000100001
100001111111110000000000000000000000000000000011111111100001
100000000000000000000000000000000000000000000000000000000001
1011111111D11111111000000000000000000000011111111D1111111101
101000000000000000100000000000000000000001000000000000000101
101000000000000000100000000000000000000001000000000000000101
101000000000000000100000000000000000000001000000000000000101
101000000000000000100000000000000000000001000000000000000101
101000000000000000100000000000000000000001111111111111111101
101000000000000000100000000000000000000000000000000000000001
101000000000000000100000000000000000000000000000000000000001
101111111111111111100000000000000000000000000000000000000001
100000000000000000000000000000000000000000000000000000000001
100000000000000000000000000000000000000000000000000000000001
100000000000000000000000000000000000000000000000000000000001
111111111111111111111111111111111111111111111111111111111111