NO incs/assets/textures/Bricks_North.xpm
SO incs/assets/textures/Bricks_South.xpm
WE incs/assets/textures/Bricks_West.xpm
EA incs/assets/textures/Bricks_East.xpm

F 0,0,0
C 3,3,3

11111111
10000011
10E000X1
1k000c11
111M111